111111111
111P0PC11
111111111
