1111111111
111PEC1111
1111111111
