111111
100101
11ECP1
100101
111111
