111111111111
1111E0C0E111
111111111111
