11111111111
11111111111
1PC00011111
100000E1111
11111111111
