1111111111111111
100000000000C1E1
1001111111111101
1101111111111101
1100000000010001
1100010101000001
11C1000000010001
10101000011C0101
1000010011111111
1010101001000001
1P10000001000001
1111111111111111
