11111
1CCE1
1CCC1
1PCC1
1CCC1
11111
